num_Cpus	1
temperature_correction	False
num_trial	5
num_generations	2000
val_pop_size	20
bestFitnessCutoff	1.1
val_neigh_size	3
val_inertia	1
val_cogn_rate	2.1
val_soc_rate	2.1
use_Keep_Best	True
use_Random_Replace	True
percent_Rand	0.05
lower_bound	-6
upper_bound	9
num_func_var	12
filesWithFunctions	[test_files\\configure_fit\\test_files\\configure_fit\\absRateFor.txt,test_files\\configure_fit\\test_files\\configure_fit\\absRateRev.txt,test_files\\configure_fit\\test_files\\configure_fit\\relRateFor_g3p.txt,test_files\\configure_fit\\test_files\\configure_fit\\relRateFor_nad.txt,test_files\\configure_fit\\test_files\\configure_fit\\relRateFor_pi.txt,test_files\\configure_fit\\test_files\\configure_fit\\relRateRev_13dpg.txt,test_files\\configure_fit\\test_files\\configure_fit\\relRateRev_nadh.txt,test_files\\configure_fit\\test_files\\configure_fit\\dKdRatio.txt,test_files\\configure_fit\\test_files\\configure_fit\\KdRatio.txt,test_files\\configure_fit\\test_files\\configure_fit\\haldaneRatio.txt]
data_file_name	test_files\configure_fit\GAPD.dat
value_row	-1
function_row	-2
data_row_high	-2
summary_file_name	test_files\configure_fit\raw\summary.txt
ultimate_result_name	test_files\configure_fit\raw\psoResults.txt